Novel of size 1: +word_boundary	#
Novel of size 1: -word_boundary	N,a,b,bh,bv,ch,d,dh,dz,dzv,e,f,g,h,i,j,k,m,n,o,p,pf,r,s,sh,sv,t,tsv,u,v,vh,w,y,z,zh,zv
Novel of size 2: -del_rel,+coronal	d,dh,j,t
Novel of size 1: -continuant	b,bh,bv,ch,d,dh,dz,dzv,g,j,k,p,pf,t,tsv
Novel of size 2: +del_rel,-anterior	ch,dzv,tsv
Novel of size 2: +continuant,+voice	vh,z,zh,zv
Novel of size 2: -continuant,+distributed	ch,j
Novel of size 2: +continuant,-voice	f,h,s,sh,sv
Novel of size 2: -continuant,+voice	b,bh,bv,d,dh,dz,dzv,g,j
Novel of size 2: -continuant,+coronal	ch,d,dh,dz,dzv,j,t,tsv
Novel of size 1: -high	a,e,o
Novel of size 1: -voice	ch,f,h,k,p,pf,s,sh,sv,t,tsv
Novel of size 2: -voice,+distributed	ch,sh
Novel of size 1: +voice	b,bh,bv,d,dh,dz,dzv,g,j,vh,z,zh,zv
Novel of size 1: -sonorant	b,bh,bv,ch,d,dh,dz,dzv,f,g,h,j,k,p,pf,s,sh,sv,t,tsv,vh,z,zh,zv
Novel of size 1: +dorsal	N,g,k
Novel of size 3: +del_rel,-voice,+labial	pf
Novel of size 1: +anterior	d,dh,dz,n,r,s,t,z
Novel of size 2: +consonantal,+sonorant	N,m,n,r,v
Novel of size 1: -consonantal	a,e,i,o,u,w,y
Novel of size 3: +continuant,+voice,+coronal	z,zh,zv
Novel of size 1: +syllabic	a,e,i,o,u
Novel of size 2: +sonorant,-syllabic	N,m,n,r,v,w,y
Novel of size 2: -approximant,+sonorant	N,m,n
Novel of size 3: +del_rel,+voice,+coronal	dz,dzv
Novel of size 1: -del_rel	b,bh,d,dh,g,j,k,p,t
Novel of size 2: -voice,+labial	f,p,pf
Novel of size 3: -del_rel,+voice,+anterior	d,dh
Novel of size 3: -continuant,+voice,+labial	b,bh,bv
Novel of size 3: +continuant,+voice,+labial	vh
Novel of size 1: +labial	b,bh,bv,f,m,p,pf,v,vh
Novel of size 2: -sonorant,+anterior	d,dh,dz,s,t,z
Novel of size 2: +del_rel,+anterior	dz
Novel of size 2: +sonorant,+dorsal	N
Novel of size 3: +continuant,-voice,-anterior	sh,sv
Novel of size 1: +sonorant	N,a,e,i,m,n,o,r,u,v,w,y
Novel of size 2: +back,+syllabic	a,o,u
Novel of size 1: -back	e,i,w
Novel of size 3: -continuant,-voice,-distributed	tsv
Novel of size 2: -implosive,+coronal	dh
Novel of size 1: -syllabic	N,b,bh,bv,ch,d,dh,dz,dzv,f,g,h,j,k,m,n,p,pf,r,s,sh,sv,t,tsv,v,vh,w,y,z,zh,zv
Novel of size 2: +del_rel,+voice	bv,dz,dzv
Novel of size 2: +del_rel,-voice	ch,pf,tsv
Novel of size 2: +voice,+anterior	d,dh,dz,z
Novel of size 2: -continuant,-distributed	dzv,tsv
Novel of size 2: -continuant,+labial	b,bh,bv,p,pf
Novel of size 2: -del_rel,-voice	k,p,t
Novel of size 3: -continuant,-voice,-anterior	ch,tsv
Novel of size 2: -continuant,+anterior	d,dh,dz,t
Novel of size 3: +continuant,-voice,+labial	f
Novel of size 2: -approximant,+coronal	ch,d,dh,dz,dzv,j,n,s,sh,sv,t,tsv,z,zh,zv
Novel of size 2: +continuant,+distributed	sh,zh
Novel of size 2: +voice,+dorsal	g
Novel of size 2: +implosive,+coronal	d
Novel of size 2: -high,-back	e
Novel of size 2: +implosive,+labial	b
Novel of size 1: +low	a
Novel of size 3: -approximant,+sonorant,+coronal	n
Novel of size 3: -high,-low,+back	o
Novel of size 3: -approximant,+sonorant,+labial	m
Novel of size 2: -del_rel,-anterior	j
Novel of size 3: -continuant,+voice,-anterior	dzv,j
Novel of size 2: -voice,+dorsal	k
Novel of size 1: +spread	h
Novel of size 3: +high,-low,-back	i
Novel of size 2: -back,-syllabic	w
Novel of size 2: +approximant,+labial	v
Novel of size 3: +high,-low,+back	u
Novel of size 2: -sonorant,+labial	b,bh,bv,f,p,pf,vh
Novel of size 2: +voice,-anterior	dzv,j,zh,zv
Novel of size 3: -continuant,-voice,+anterior	t
Novel of size 3: +continuant,-voice,+anterior	s
Novel of size 1: -anterior	ch,dzv,j,sh,sv,tsv,zh,zv
Novel of size 2: +approximant,+coronal	r
Novel of size 1: -implosive	bh,dh
Novel of size 3: -del_rel,-voice,+labial	p
Novel of size 3: -del_rel,+voice,+labial	b,bh
Novel of size 2: +continuant,-distributed	sv,zv
Novel of size 3: +continuant,+voice,+anterior	z
Novel of size 2: +back,-syllabic	y
Novel of size 2: +voice,+distributed	j,zh
Novel of size 1: +coronal	ch,d,dh,dz,dzv,j,n,r,s,sh,sv,t,tsv,z,zh,zv
Novel of size 2: -voice,-distributed	sv,tsv
Novel of size 3: +del_rel,+voice,+labial	bv
Novel of size 1: -distributed	dzv,sv,tsv,zv
Novel of size 2: -continuant,-anterior	ch,dzv,j,tsv
Novel of size 2: -voice,-anterior	ch,sh,sv,tsv
Novel of size 2: +del_rel,+coronal	ch,dz,dzv,tsv
Novel of size 1: -approximant	N,b,bh,bv,ch,d,dh,dz,dzv,f,g,h,j,k,m,n,p,pf,s,sh,sv,t,tsv,vh,z,zh,zv
Novel of size 2: -del_rel,+anterior	d,dh,t
Novel of size 3: +continuant,-voice,-distributed	sv
Novel of size 2: +voice,+labial	b,bh,bv,vh
Novel of size 2: -implosive,+labial	bh
Novel of size 3: -continuant,-voice,+labial	p,pf
Novel of size 2: -sonorant,+coronal	ch,d,dh,dz,dzv,j,s,sh,sv,t,tsv,z,zh,zv
Novel of size 3: -del_rel,+voice,+coronal	d,dh,j
Novel of size 1: +distributed	ch,j,sh,zh
Novel of size 1: +continuant	f,h,s,sh,sv,vh,z,zh,zv
Novel of size 1: +back	a,o,u,y
Novel of size 1: -low	e,i,o,u
Novel of size 1: +consonantal	N,b,bh,bv,ch,d,dh,dz,dzv,f,g,h,j,k,m,n,p,pf,r,s,sh,sv,t,tsv,v,vh,z,zh,zv
Novel of size 3: +continuant,-voice,+distributed	sh
Novel of size 2: -voice,+coronal	ch,s,sh,sv,t,tsv
Novel of size 3: +continuant,+voice,-anterior	zh,zv
Novel of size 2: +voice,-distributed	dzv,zv
Novel of size 2: +continuant,+coronal	s,sh,sv,z,zh,zv
Novel of size 2: +del_rel,+distributed	ch
Novel of size 3: +continuant,-voice,+coronal	s,sh,sv
Novel of size 3: +continuant,+voice,+distributed	zh
Novel of size 2: -low,-back	e,i
Novel of size 1: +del_rel	bv,ch,dz,dzv,pf,tsv
Novel of size 2: +approximant,-syllabic	r,v,w,y
Novel of size 1: +implosive	b,d
Novel of size 2: -approximant,+anterior	d,dh,dz,n,s,t,z
Novel of size 3: +continuant,+voice,-distributed	zv
Novel of size 1: +high	i,u,w,y
Novel of size 2: +high,-low	i,u
Novel of size 1: +approximant	a,e,i,o,r,u,v,w,y
Novel of size 2: -del_rel,+labial	b,bh,p
Novel of size 2: -high,-low	e,o
Novel of size 3: -continuant,+voice,+anterior	d,dh,dz
Novel of size 3: -continuant,+voice,+coronal	d,dh,dz,dzv,j
Novel of size 3: -continuant,-voice,+coronal	ch,t,tsv
Novel of size 2: +del_rel,+labial	bv,pf
Novel of size 2: -high,+back	a,o
Novel of size 3: -continuant,+voice,-distributed	dzv
Novel of size 2: -sonorant,+dorsal	g,k
Novel of size 2: +high,+back	u,y
Novel of size 2: +continuant,+anterior	s,z
Novel of size 2: +continuant,-anterior	sh,sv,zh,zv
Novel of size 2: -approximant,+labial	b,bh,bv,f,m,p,pf,vh
Novel of size 2: +consonantal,+approximant	r,v
Novel of size 2: -voice,+anterior	s,t
Novel of size 2: -low,+back	o,u
Novel of size 2: +sonorant,+labial	m,v
Novel of size 2: +high,-back	i,w
Novel of size 2: +sonorant,+coronal	n,r
Novel of size 2: -del_rel,+voice	b,bh,d,dh,g,j
Novel of size 2: +continuant,+labial	f,vh
Novel of size 2: -consonantal,-syllabic	w,y
Novel of size 2: -continuant,-voice	ch,k,p,pf,t,tsv
Novel of size 2: +voice,+coronal	d,dh,dz,dzv,j,z,zh,zv
